Country name - Full NAME  

afghanistan - Afghanistan
albania - Albania
algeria - Algeria
angola - Angola
anguilla - Anguilla
antiguaandbarbuda - Antigua and Barbuda
argentina - Argentina
armenia - Armenia
aruba - Aruba
australia - Australia
austria - Austria
azerbaijan - Azerbaijan
bahamas - Bahamas
bahrain - Bahrain
bangladesh - Bangladesh
barbados - Barbados
belarus - Belarus
belgium - Belgium
belize - Belize
benin - Benin
bhutane - Bhutan
bih - Bosnia and Herzegovina
bolivia - Bolivia
botswana - Botswana
brazil - Brazil
bulgaria - Bulgaria
burkinafaso - Burkina Faso
burundi - Burundi
cambodia - Cambodia
cameroon - Cameroon
canada - Canada
capeverde - Cape Verde
caymanislands - Cayman Islands
chad - Chad
chile - Chile
china - China
colombia - Colombia
comoros - Comoros
congo - Congo
costarica - Costa Rica
croatia - Croatia
cuba - Cuba
cyprus - Cyprus
czech - Czechia
djibouti - Djibouti
dominica - Dominica
dominicana - Dominican Republic
drcongo - DR Congo
easttimor - East Timor
ecuador - Ecuador
egypt - Egypt
england - England
equatorialguinea - Equatorial Guinea
eritrea - Eritrea
estonia - Estonia
ethiopia - Ethiopia
finland - Finland
france - France
frenchguiana - French Guiana
gabon - Gabon
gambia - Gambia
georgia - Georgia
germany - Germany
ghana - Ghana
greece - Greece
grenada - Grenada
guadeloupe - Guadeloupe
guatemala - Guatemala
guinea - Guinea
guineabissau - Guinea-Bissau
guyana - Guyana
haiti - Haiti
honduras - Honduras
hongkong - Hong Kong
hungary - Hungary
india - India
indonesia - Indonesia
iran - Iran
iraq - Iraq
ireland - Ireland
israel - Israel
italy - Italy
ivorycoast - Ivory Coast
jamaica - Jamaica
japan - Japan
jordan - Jordan
kazakhstan - Kazakhstan
kenya - Kenya
kuwait - Kuwait
kyrgyzstan - Kyrgyzstan
laos - Laos
latvia - Latvia
lesotho - Lesotho
liberia - Liberia
libya - Libya
lithuania - Lithuania
luxembourg - Luxembourg
macau - Macau
madagascar - Madagascar
malawi - Malawi
malaysia - Malaysia
maldives - Maldives
mali - Mali
mauritania - Mauritania
mauritius - Mauritius
mexico - Mexico
moldova - Moldova
mongolia - Mongolia
montenegro - Montenegro
montserrat - Montserrat
morocco - Morocco
mozambique - Mozambique
myanmar - Myanmar
namibia - Namibia
nepal - Nepal
netherlands - Netherlands
newcaledonia - New Caledonia
newzealand - New Zealand
nicaragua - Nicaragua
niger - Niger
nigeria - Nigeria
northmacedonia - North Macedonia
norway - Norway
oman - Oman
pakistan - Pakistan
panama - Panama
papuanewguinea - Papua New Guinea
paraguay - Paraguay
peru - Peru
philippines - Philippines
poland - Poland
portugal - Portugal
puertorico - Puertorico
qatar - Qatar
reunion - Reunion
romania - Romania
russia - Russia
rwanda - Rwanda
saintkittsandnevis - Saint Kitts and Nevis
saintlucia - Saint Lucia
saintvincentandgrenadines - Saint Vincent and the Grenadines
salvador - Salvador
samoa - Samoa
saotomeandprincipe - Sao Tome and Principe
saudiarabia - Saudi Arabia
senegal - Senegal
serbia - Serbia
seychelles - Republic of Seychelles
sierraleone - Sierra Leone
singapore - Singapore
slovakia - Slovakia
slovenia - Slovenia
solomonislands - Solomon Islands
somalia - Somalia
southafrica - South Africa
southsudan - South Sudan
spain - Spain
srilanka - Sri Lanka
sudan - Sudan
suriname - Suriname
swaziland - Swaziland
sweden - Sweden
switzerland - Switzerland
syria - Syria
taiwan - Taiwan
tajikistan - Tajikistan
tanzania - Tanzania
thailand - Thailand
tit - Trinidad and Tobago
togo - Togo
tonga - Tonga
tunisia - Tunisia
turkey - Turkey
turkmenistan - Turkmenistan
turksandcaicos - Turks and Caicos Island
uae - UAE
uganda - Uganda
ukraine - Ukraine
uruguay - Uruguay
usa - USA
uzbekistan - Uzbekistan
venezuela - Venezuela
vietnam - Vietnam
virginislands - British Virgin Islands
yemen - Yemen
zambia - Zambia
zimbabwe - Zimbabwe